%%%%%%%%%%%%%%%%%%%%%%%%%%%%%
%1                         2%
% %%%% %%%%% %%%%%% % % % % %
%                   % % % % %
% %%%% %%%%% %%%%%% % % % % %
%                        3  %
% %4% % %o%%%%%%% % % % % % %
% % % %           % % % % % %
% % % % %%%%oooo% % % o % % %
%                 % % % % % %
% % % % %% %oooo% % % % % % %
% % o %    P                %
% % % % %% %%%%%% %%% %%%%% %
%         b  cA  a   d      %
%%%o%%%%%%%%%%%%%%%%%%%o%%%%%